end_career_on	end his active career	dbo:activeYearsEndDate	on
end_in	end	dbo:routeEnd	in
come_from	come	dbo:nationality	from
flow_into	flow	dbo:inflow	into
grow_in	grow	dbo:growingGrape	in
die_from_1	die	dbo:deathCause	from
born_in_1	born	dbo:birthYear	in
born_in_2	born	dbo:birthPlace	in
born_in_3	born	dbo:birthPlace	in
born_in_4	born	dbo:birthPlace	in
born_in_5	born	dbo:birthPlace	in
born_in_6	born	dbo:birthPlace	in
born_in_7	born	dbo:birthPlace	in
dissolve_on_1	dissolve	dbo:dissolutionDate	on
written_in	write	dbo:programmingLanguage	in
complete_in_1	complete	dbo:completionDate	in
participate_in_1	participate	dbo:battle	in
die_on_1	die	dbo:deathDate	on
die_in_1	die	dbo:deathDate	in
die_in_2	die	dbo:deathPlace	in
die_in_3	die	dbo:deathPlace	in
die_in_4	die	dbo:deathPlace	in
die_in_5	die	dbo:deathPlace	in
die_from_1	die	dbo:deathCause	from
bury_in_1	bury	dbo:restingPlace	in
locate_in_1	locate	dbo:country	in
locate_in_2	locate	dbp:location	in
locate_in_3	locate	dbp:location	in
locate_in_4	locate	dbo:country	in
locate_in_5	locate	dbo:locatedInArea	in
found_in_1	found	dbo:foundingYear	in
found_in_2	found	dbo:foundationPlace	in
commence_on_1	commence	dbp:date	on
commence_on_2	commence	dbo:date	on
call_1	call	dbp:nickname	X
KnownFor_1	known	dbo:knownFor	for
KnownFor_2	known	dbo:knownFor	for
locate_in_1	locate	dbo:country	in
locate_in_2	locate	dbp:location	in
locate_in_3	locate	dbp:location	in
live_in_1	live	dbo:residence	in
live_in_2	live	dbo:residence	in
live_in_3	People live	dbo:populationTotal	in
live_in_4	People live	dbo:populationTotal	in
grow_in_2	grow	dbo:growingGrape	in
flow_through_1	flow	dbo:city	through
flow_through_2	flow	dbp:country	through
start_in_1	start	dbo:routeStart	in
start_in_2	start	dbp:mouthLocation	in
flow_into	flow	dbo:inflow	into
fight_in	fight	dbp:date	in
produced_in_1	produce	dbo:wineProduced	in
stand_for_2	stand	dbo:abbreviation	for
operate_1	operate	dbo:operator	by
belong_to_1	belong	dbo:party	to
Have_seat_1	have	dbo:seatingCapacity	X